GGGGGGGGGGGGGGGGGGGGGGGGGGGGGGGGGGGGGGGGGGGGGGGGGG
GWWWWWWWWWWWWGWWWWWWWWWWWWWWWWWWWGWWWWWWWWWWWGWWWG
GWWWWWWWWWWWGWWWWWWWWWWWWWWWWWWWWGWWWWWWWWWWWGWWWG
GWWWWWWWWWWWWWWWWWWWWWGWWWWWWWWWWGWWWWWGGWWWWGWWWG
GWWGWWWWWWWWWWWWWWWWWWGWWWWWWWWWGGWWWWWWWWWWWWWWWG
GWWGWWWWWWGGGGGGGGGGGGGGGGWWWWWWWWWWWWWWWWWWWWWWWG
GWWWGGWWWWWWWWWWWWGWWWWWGWWWWWWWWWWWWWWWWWWWWWGGGG
GWWWWWGWWWWWWWWWWWGWWWWWWWWWWWWWWGWWWWWWWWWWWWWWWG
GWWWWWGWWWWWWWWWWWGWWWWWWWWWWWWWWGGGGGGGGGWWWWWWWG
GWWWWWWWWWWGWWWWWWWWWWWWWWWWWWWWWWWWWWWWWWWWWWWWWG
GWWWWWWWWWWGGGGWWWWWWWWWWWWWWWWWWWGWWWWWWWWWWWWWWG
GWWWWWWWWWWWWGGWWWWWWWWWWWWWWGWWWWGWWWWWWWWWWWWWWG
GGGGGWWWWWWWWGGWWWWWWWWWWWWWGWWWWWGWWWWWWWWWWWWWWG
GWWWWWWWWWWWWWWWWWWWWWWWWWWGWWWWGGGWWWWWWGWWWWWWWG
GWWWWWWGGGGWWWWWWWWWWWWWGGGWWWWWWWWWWWWWWGWWWWWWWG
GWWWWWWWWGWWWWWWWWWWWWWWWWGWWWWWWWWWWWWWWGGGGWWWWG
GWWWGWWWWGWWWWWWWWWWWWWWWGGWWWWWWWWWWWWWGWWWWWWWWG
GWWWGWWWWWWWWWWWGGWWWWWWWWGWWWWGGWWWWWWGWWWWWWWWWG
GWWWGWWWWWWWWWWWGGWWWWGWWWWWWWWGGWWWWWGWWWWWWWWWWG
GWWWGWWWWWWWWWWWGGWWWWWGWWWWWWWWWWWWWGWWWWWWWWWWWG
GGWWGWWWWWWWGGWWWWWWWWWWGWWWWWWWWWWWGWWWWWWWWWWWWG
GWWWGWWWWWWWGWWWWWWWWWWWWGWWWWWWWWWGWWWWWWWWWWWWWG
GWWWGWWWWWWWWWWWWWWGGGGGGGGGGGGGGGGWWWWWWWWWWWGWWG
GWWWWWWWGWWWWWWWWWWWWWWWWWGWWWWWWWWWWWWWWWWWWWWGWG
GWWWWWWWGWWWGWWWWWWWWWWWWWGGGWWWWWWWWWWWWWWWWWWWGG
GWWWWWWWGWWWWGGWWWWWWWWWWWGWWWWWWWWWWWWWWWWWWWWWWG
GWWWWWWWGGGGGGWWWWWGWWWWWWGWWWWWWWWWWWWWGGGGWWWWWG
GWWWWWWWWWWWWWWWWWWGWWWWWWWWWWWWWWGWWWWWWWWWWWWWWG
GWWWWWGGGGGGWWWWWWWGWWWWWWWWWWWWWWWGWWWWWWWWWWWWWG
GWWWWWGGGGWWWWWWWWWGWWWWWWWWWWWWGGGGGGWWWWWWWWWWWG
GWWGGGGGGGWWWWWWWWWWWWWWGGGGWWWWGGGGGGWWWWWWWWWWWG
GWWWWWWWGGGGGGGGWWWWWWWWWGGGWWWWGGGGGGWWWWWWWWWWWG
GWWWWWWGGGGWWWWWWWWWWWWWWWGGWWWWWWWWWWWWWWWWWWWWWG
GWWWWWWGWWWWWWWWWWGGGGWWWWWGGWWWWWWWWWWGGGGGGGWWWG
GWGWWWWWGWWWWWWWWWWWWGGGWWWWWWWWWWWWWWWWWWWWWWWWWG
GWGWWWWWWGWWWWGWWWWWWWWGGGWWWWWWGGGGWWWWWWWWWWWWWG
GWGWWWWWWWWWWGWWWWWWWWWWWWWWWWWWWWWGGGGGWWWWWWWWWG
GWGWWWWWWWWWWWGWWWWWWWWWWWWWWWWWWWWWWWGGGWWWWWWWWG
GWWWWWWGGGGWWWGWWWWWWWGGGGGGWWWWWWWWWWWWWWWWWWWWWG
GWWWWWWGWWWWWWGWWWGWWWWWWGGGGGGWWWWWWWWWWWWWWWWWWG
GWWWWWGWWWWWWWWWWWGWWWWWGGGWWWWWWWWWWWWWWGGGGWWWWG
GWWWWGWWWWWWWWWWWGWWWWWGGGWWWWWWWWWWWWWWWWWWWWWWWG
GWWWWGGGGGWWWWWWGWWWWWWWWWWWWWGGGGGGWWWWWWWWWWWWWG
GWWWWWWWWWWWWWWWGWWGGGGGGGGGGGGWWWWWWWWWWWGWWWWGGG
GWWWWWWWWWWWWWWWGWWWWWWWWGWWWWWWWWWWGGWWWWWWWWGGWG
GGWWWWWWWWWWGGGGWWWWWWWWWGWWWWWWWWGGGGGWWWWWWWWWWG
GGGWWWWWWWWWWWWWWWWWWWWWWGWWWWWWWWWWWGGGGGWWWWWWWG
GGGGWWW^WWWWWWWWWWGGWWWWWWWWWWWWWWGWWWWWWWWWWWWWWG
GGGGGWWWWWWWWWWWWWWGGWWWWWWWWWWWWWWGWWWWWWWWWWWWWG
GGGGGGGGGGGGGGGGGGGGGGGGGGGGGGGGGGGGGGGGGGGGGGGGGG